15,7
GGGGGGGGGGGGGGG
GPPPTTPPPTTPPPG
GGGPGGGGPGGPGPG
GPPPGGPPPGGPGPG
GPGGGGGGPGGPGPG
GPPPTTPPPTTPPPG
GGGGGGGGGGGGGGG
3,2
3,4