15,7
GGGGGGGGGGGGGGG
GPPPPPPPTTPPPPG
GGGPGGGGGGGPGGG
GPPPPPPPTPPPPPG
GPGGGGGGTGGGGPG
GPPPTTPPTPPPPPG
GGGGGGGGGGGGGGG
3,2
3,4